111111
100001
102031
100001
111111
